#######################################
#A# # # # #   # #   #     # # # # # #B#
# # # ### ### # ### # ##### # ### ### #
#   #   #   #   #   #       #   #   # #
##### ### # ##### ############### # # #
#     #   #     #         # #   #   # #
# ### # ######### ##### # # # ##### ###
#   # #   #   #       # # # #   #     #
### # # # # # ######### # # ##### ### #
#   # #   #   #       # # # #       # #
# ### ##### ### # # # # ### # ##### # #
# #   #   #     # # # #   #   #     # #
# ### # # # # # ### ##### ##### # # # #
#   # # #   #   #   #     #     # # # #
# ### # ####### # ##### # ### ##### # #
#     #         #     # #   #       # #
#######################################
